     Глобальные:
Q, ESC - Выход/вернуться назад.
     Режим симуляция:
UP     - увеличить размер кисти.
DOWN   - уменьшить размер кисти.
W      - выбрать кисть стены.
D      - выбрать кисть удаления.
C      - выбрать кисть очистки.
F      - выбрать кисть среды F.
E      - выбрать кисть жизненной формы E.
N      - выбрать кисть жизненной формы N.
A      - выбрать кисть жизненной формы A.
G      - выбрать кисть жизненной формы G.
I      - выбрать кисть жизненной формы I.
U      - выбрать кисть жизненной формы U.
Z      - выбрать кисть жизненной формы Z.
O      - выбрать кисть жизненной формы O.
X      - выбрать кисть жизненной формы X.
Y      - выбрать кисть жизненной формы Y.
S      - сохранить.
R      - загрузить.
     Меню:
P      - симулировать.
H      - помощь.
     Помощь:
1      - подгрузить описание.
2      - подгрузить список горячих клавиш.
J      - прокрутка вверх на 5 пикселей.
K      - прокрутка вниз на 5 пикселей.
UP     - прокрутка вверх на 3 пикселей.
DOWN   - прокрутка вниз на 3 пикселей.
0      - прокрутка вверх.
**

